ANCHOR: WHAT DO YOU THROW OUT WHEN YOU WANT TO USE IT BUT TAKE IN WHEN YOU DON'T WANT TO USE IT?
ARTICHOKE: WHAT HAS A HEART THAT DOESNT BEAT?
BANK: WHAT HAS BRANCHES, BUT NO FRUIT, TRUNK, OR LEAVES?
BED: WHAT HAS ONE HEAD, ONE FOOT, AND FOUR LEGS?
BREATH: WHAT'S LIGHTER THAN A FEATHER BUT IMPOSSIBLE TO HOLD FOR MUCH MORE THAN A MINUTE?
CALENDAR: NO MATTER HOW LITTLE OR MUCH YOU USE ME, I STILL CHANGE EVERY MONTH.
CAR: WHAT HAS THREE LETTERS AND STARTS WITH GAS?
CARPET: WHAT IS BOUGHT BY THE YARD AND WORN BY THE FOOT?
CLOCK: WHAT HAS HANDS BUT NEVER WASHES THEM?
COMB: WHAT HAS TEETH BUT CANNOT BITE?
CUTLERY: WHAT DO YOU BUY TO EAT BUT NEVER CONSUME?
DARKNESS: THE MORE THERE IS THE LESS YOU SEE. WHAT IS IT?
DOZENS: A WORD I KNOW, SIX LETTERS IT CONTAINS, REMOVE ONE LETTER AND 12 REMAINS. WHAT IS IT?
EGG: WHAT MUST BE BROKEN THE BEFORE YOU CAN USE IT?
ELECTRICITY: WHAT'S THE NAME OF A CITY WHERE NOBODY LIVES?
FIVE: JANE AND JOHN HAVE FOUR DAUGHTERS. EACH OF THEIR DAUGHTERS HAS ONE BROTHER. HOW MANY CHILDREN DO JANE AND JOHN HAVE?
FOOTPRINTS: THE MORE YOU TAKE, THE MORE YOU LEAVE BEHIND. WHAT AM I?
FROSTBITE: WHAT DO YOU GET IF YOU CROSS A SNOWMAN WITH AN ALLIGATOR?
FUTURE: WHAT IS ALWAYS IN FRONT OF YOU BUT CAN'T BE SEEN?
KITTEN: I HAVE A HEAD LIKE A CAT AND FEET LIKE A CAT, BUT I AM NOT A CAT. WHAT AM I?
LEGS: WHAT HAS A BOTTOM AT THE TOP?
LIGHT: WHAT CAL FILL A ROOM BUT TAKES UP NO SPACE?
MAP: I HAVE CITIES, BUT NO HOUSES. I HAVE FORESTS BUT NO TREES. I HAVE WATER BUT NO FISH. WHAT AM I?
MONEY: PEOPLE MAKE ME, SAVE ME, CHANGE ME, RAISE ME. WHAT AM I?
PIANO: WHAT HAS MANY KEYS BUT CANNOT OPEN A SINGLE LOCK?
PRISON: WHERE CAN YOU FINISH A BOOK WITHOUT FINISHING A SENTENCE?
PYRAMID: BUILT FOR A KING, MY BODY GUARDS HIM IN DEATH, NOT IN LIFE. I STAND TALL, POINTING TO THE SKIES, YET I AM NOT ALIVE. WHAT AM I?
QUEUE: WHAT FIVE-LETTER WORD CAN BE PRONOUNCED THE SAME EVEN WITH FOUR OF ITS LETTERS REMOVED?
ROAD: WHAT GOES AROUND THE CORNER BUT NEVER MOVES?
SCREWDRIVER: WHAT KIND OF DRIVER NEVER GETS A TICKET?
SHADOW: WHAT'S ALWAYS FOUND ON THE GROUND BUT NEVER GETS DIRTY?
SHOE: WHAT HAS A TONGUE BUT NEVER TALKS, AND HAS NO LEGS BUT SOMETIMES WALKS?
SHORT: WHAT FIVE-LETTER WORD BECOMES SHORTER WHEN YOU ADD TWO LETTERS TO IT?
SILENCE: IF YOU SAY MY NAME, I'M ALREADY GONE. WHAT AM I?
SPONGE: WHAT IS FULL OF HOLES AND CAN STILL HOLD WATER?
STAPLER: WITH POINTED FANGS I SIT AND WAIT; WITH PEIRCING FORCE I CRUNCH OUT FATE; GRABBING VICTIMS, PROCLAIMING MIGHT; PHYSICALLY JOINING WITH SINGLE BITE. WHAT AM I?
STONE: WHAT FIVE-LETTER WORD HAS ONE LEFT WHEN TWO LETTERS ARE REMOVED?
TABLE: WHAT HAS FOUR LEGS BUT CAN'T WALK?
TEAPOT: WHAT STARTS WITH T, ENDS WITH T, AND HAS T IN IT?
TIME: UNTIL I AM MEASURED, I AM NOT KNOWN. YET HOW YOU MISS ME, WHEN I HAVE FLOWN. WHAT AM I?
TON: FORWARD I AM HEAVY, BUT BACKWARDS I AM NOT. WHAT AM I?
TONGUE: WHAT TASTES BETTER THAN IT SMELLS?
TOMORROW: WHAT IS COMING BUT NEVER ARRIVES?
TOWEL: WHAT GETS WETTER THE MORE IT DRIES?
TREE: WHAT HAS NO FINGERS BUT MANY RINGS?
TULIPS: WHAT FLOWERS ARE KISSABLE?
UMBRELLA: WHAT CAN GO UP A CHIMNEY DOWN, BUT CAN'T GO DOWN A CHIMNEY UP?
WIND: WHAT FLIES FOREVER, RESTS NEVER?
WRONG: WHAT WORD IS ALWAYS PRONOUNCED WRONG?
YARDSTICK: WHAT HAS ONE FOOT ON EACH SIDE AND A FOOT IN THE MIDDLE?